NO textures/wall.png
EA textures/wall2.png
SO textures/wall3.png
WE textures/wall4.png

C 20,20,80
F 20,80,20


111111111111
100000001101
100010001101
100001001101
100000001101
100000001101
11N010000001
111111111111