NO textures/starry1.png
EA textures/mona.png
SO textures/perl.png
WE textures/letter.png
D textures/door.png
SP textures/merkava1.png
C 0,0,0
F 0,0,0


111111111111
100000001101
100000001101
10111A111111
100010101101
100000A01101
11N010000001
111111111111