NO bonus/textures/wall8.png
EA bonus/textures/wall8.png
SO bonus/textures/wall8.png
WE bonus/textures/wall8.png
D bonus/textures/doors/door5.png
SP bonus/textures/enemy/m5.png

C 0,0,0
F 0,0,0


111111111111111
100000100000001
100S0011111111111111111111
10000010000000000000010001
100000A00000000000000D0001
10000010000000000000010001
111D1111111D11111111110001
110000110000001      10001
100000010000001      10001
100000010000001      10001
1000000D000000111111111D11111111111
10000001000000100000000000000000001
100000010000001000000000000000000011111
110000110000001001110000000000110010001
111111111111111001000000000000010010001
              1000000000000000000010001
              1000000000000000000010001
              10000000000000000000D0001
              1000000000000000000010001
              10000000000000000000A0001
              1001000000000000010010001
              1001100000000001A10010001
              1000000000000000000010001
              1000000000000000000010001
              1111111111111111111110001
                                  10001
                               11110001111
                               10000000001
   1111111111111               10000000001
   1000000000001               10000000001
   1000000000001               10000000001
   1000000000001               10000000001
   1000000000001               10000000001
   1000000000001               10000000001
   10011111111111111111111     11111D11111
   100D0000000000000000001       100001
   11110000000000000000001       100001
      10000000000000000001       100001
  11111000000000000111D1111111111100001
  1000D00000000000010000000000000000001
  1000100000000000010000000000000000001
  1000100000000000010000000000000000001
  1000111111D11111110000000000000000001
  1000000010001    111D1111111111111111
  1000000010001    100000000001
  1000000010001    100000000001
  1111011110001    100000000001
    10001 10001    100000000001
    10001111111    100000000001
    10000000001    100000000001
    11111100001    111111011111
         110001        10001
          10001        10001
           10001       10001
            10001      11111
             10001
              10001
               11111
