NO textures/wall3.png
EA textures/wall3.png
SO textures/wall3.png
WE textures/wall3.png

C 0,0,12
F 101,67,33


111111111111
100000001101
100010001101
100001001101
100100001101
100000001101
11N010000001
111111111111